NO ./textures/no_text.xpm
SO ./textures/so_text.xpm
EA ./textures/ea_text.xpm
WE ./textures/we_text.xpm

F 220,100,0
C 225,30,0

        1111111111111111111111111
        1000000000110000000000001
        1011000001110000000000001
        1001000000000000000000001
111111111011000001110000000000001
1000000000110000011101111111111111
1111011111111101110000001000111111111111
11110111111111001111010010001
11000000110101011100000010001
10000000000000001100000010001
1000000000000000110101001000111
11000001110101011111001000N01
11110111 1110101 101111010001
11111111 1111111 111111111111