NO ./textures/no_text.xpm
SO ./textures/so_text.xpm
EA ./textures/ea_text.xpm
WE ./textures/we_text.xpm
DO ./textures/do_text.xpm

F ./textures/floor.xpm
C ./textures/sky.xpm

        11111111111111111111111111
        11000000000110000000000001
        10110000011100000000000011
        1001000000000000000000001
111111111011000001110000000000001
100000000011000001110111D111111111
1111011111111101110000000000111111111111
111110111111111001111010000001
11000000110101011100000000001
10000000000000001D000000S0001
100000000000000011010100000111
11000001110101011111001000001
1110111 1110101 101111010001
11111111 1111111 111111111111
