NO ./textures/no_text.xpm
SO ./textures/so_text.xpm
EA ./textures/ea_text.xpm
WE ./textures/we_text.xpm
DO ./textures/do_text.xpm

F ./textures/floor.xpm
C ./textures/sky.xpm

        1111111111111111111111111
        1000000000110000000000001
        1011000001110000000000001
        1001000000000000000000001
111111111011000001110000000000001
100000000011000001110111D111111111
1111011111111101110000000000111111111111
11110111111111001111010000001
11000000110101011100000000001
10000000000000001D00000000001
1000000000000000110101000000111
11000001110101011111001000N01
11110111 1110101 101111010001
11111111 1111111 111111111111